control the budget - kontrolować budżet
legislative power - władza ustawodawcza
parliament - parlament
pass new laws - uchwalać nowe ustawy
ratify - ratyfikować
the senate - senat
administer the country - rządzić krajem
government - rząd
implement laws - wdrażać ustawy
monarch - monarcha
president - prezydent
prime minister - premier
apply the law - stosować prawo
judiciary power - władza sądownicza
punishment - kara
punish offenders - karać przestępców
resolve disputes - rozstrzygać spory
civil liberties - swobody obywatelskie
communicate ideas and opinions - głosić poglądy
due process of law - właściwa procedura prawna
fair trial - sprawiedliwy proces
freedom of assembly - wolność zgromadzeń
freedom of association - wolność zrzeszania się
freedom of conscience - wolność sumienia
freedom of speech and expression - wolność słowa
gather - zbierać się
hold moral - mieć poglądy moralne
presume somebody innocent - uważać kogoś za niewinnego
prove somebody guilty - udowodnić czyjąś winę
restrictions - ograniczenia
right to bear arms - prawo do noszenia broni
rights of the accused - prawa oskarżonego
universal suffrage - powszechne prawo wyborcze
violate somebody's rights - naruszać czyjeś prawa
aid - pomoc humanitarna
bribe - przekupić/łapówka
bribery - łapówkarstwo
destitution - nędza / ubóstwo
discriminate against somebody - dyskryminować kogoś
embezzlement - defraudacja
equal opportunities - równouprawnienie
ethnic prejudice - uprzedzenia na tle etnicznym
evict - wyeksmitować
illiteracy - analfabetyzm
impunity - bezkarność
lack of transparency - brak przejrzystości
poverty - bieda
racism - rasizm
shelter - schronisko
sleep rough - spać pod gołym niebem
social benefits - świadczenia socjalne
social inequality - nierówności społeczne
social security - opieka społeczna
starvation - głód
unemployment - bezrobocie
confidential - poufny
conspiracy/plot - spisek
cover something up - zatuszować coś
forthcoming elections - nadchodzące wybory
general election - wybory powszechne
hear evidence - wysłuchać zeznań
compassion - współczucie / litość
compass something - osiągać coś
ruthless - bezlitosny
settle - rozstrzygać spór
resemblance - podobieństwo
canny - przebiegły sprytny
uncanny - zadziwiający / niesamowity
mettle - gorliwość / zapał / odwaga
attempt - próbować/usiłować
regarding of - branie pod uwagę
slight - mały/niewielki
tweak - poprawka (wprowadzać drobne zmiany)
pull in - przyciągać
doom - śmierć / nieuchronność
Buggy - mały samochód terenowy
exhibition - wystawa
sculpture - rzeźba
sketch - szkic
monument - pomnik
audience - widownia
box office - kasa biletowa
rubble - gruzy
peering - przyglądanie się (badawczo)
fade - znikać/gasnąć
seek - poszukiwać/ dążyć do
retribution - sroga kara/ odwet/zemsta
flame - płomień
throw down - ściągnąć na dół
brush - szczotka
forehead/brow - czoło
powder - proszek
beetroot - burak
rube - wieśniak / głupek
humble - pokorny
caveat - zastrzeżenie / sprzeciw
point out - zwracać uwagę
whereas - podczas gdy / zważywszy że
tedious - żmudny
gore - przebić (sobie coś)
pierce - przebić ucho
unfold - rozkładać
set something out - rozłożyć coś
knock over - strącić coś
hive - ul dla pszczół
liberating - wyzwalający
subsequent - kolejny / dalszy
concurrent - równoczesny
back to back - jeden po drugim
grind - mielić / posiekać
conquest - podbój
graduate from school - ukończyć szkołę
adulthood - dorosłość
comfort / convenience - wygoda
privilege - przywilej
establishment - placówka
convincing - przekonywujący
to prohibit - zakazać
divine - boski
endanger - zagrozić
accusing - oskarżać
accompany - towarzyszyć
refugee - uchodźca
persecution - prześladowanie
relegation - degradacja
violate - naruszać
breach - pogwałcać
solely - wyłącznie / jedynie
accused - oskarżony
struggle - zmagać się / wysilać się
pitfall - problem
pitiful - budzący litość / żałosny